{
    "matrix":   [2, 2, 2, 2, 2, 2, 2, 2, 2, 2,
                10, 10, 10, 10, 10, 10, 10, 10, 10, 10,
                9, 9, 9, 9, 9, 9, 9, 9, 9, 9,
                6, 6, 6, 6, 6, 6, 6, 6, 6, 6,
                8, 8, 8, 8, 8, 8, 8, 8, 8, 8,
                7, 7, 7, 7, 7, 7, 7, 7, 7, 7,
                0, 0, 0, 0, 0, 0, 0, 0, 0, 0,
                0, 0, 0, 0, 0, 0, 0, 0, 0, 0,
                0, 0, 0, 0, 0, 0, 0, 0, 0, 0,
                0, 0, 0, 0, 0, 0, 0, 0, 0, 0]
}
