{
    "matrix":  [5, 5, 5, 5, 5, 5, 5, 5, 5, 5,
                5, 5, 5, 5, 5, 5, 5, 5, 5, 5,
                5, 5, 5, 5, 15, 15, 15, 5, 5, 5,
                5, 5, 5, 5, 15, 15, 15, 5, 5, 5,
                5, 5, 5, 5, 15, 15, 15, 5, 5, 5, 
                5, 5, 5, 5, 15, 15, 15, 5, 5, 5,
                5, 5, 5, 5, 15, 15, 15, 5, 5, 5,
                5, 5, 5, 5, 15, 15, 15, 5, 5, 5,
                5, 5, 5, 5, 15, 15, 15, 5, 5, 5,
                5, 5, 5, 5, 15, 15, 15, 5, 5, 5]
}
