{
    "matrix":  [6, 0, 0, 0, 5, 5, 0, 0, 0, 6,
                0, 6, 0, 0, 5, 5, 0, 0, 6, 0,
                0, 0, 6, 0, 5, 5, 0, 6, 0, 0,
                0, 0, 0, 6, 5, 5, 6, 0, 0, 0,
                0, 0, 0, 6, 0, 0, 6, 0, 0, 0,
                0, 0, 6, 0, 0, 0, 0, 6, 0, 0,
                0, 6, 0, 0, 0, 0, 0, 0, 6, 0,
                4, 4, 4, 4, 4, 4, 4, 4, 4, 4,
                4, 4, 4, 4, 4, 4, 4, 4, 4, 4,
                11, 4, 4, 13, 4, 4, 12, 4 ,4, 14]
}
